R   600, 540
NO  ./textures/strs.xpm
SO  ./textures/eyeballs.xpm
WE ./textures/flw.xpm
EA  ./textures/shrooms2.xpm
S   ./textures/muhomor.xpm
F   38, 38, 38
C   60, 60, 60
      1111111111
1111111000000001
1000000001100001  1
10000N0000100001  1
1001000000000001111
1001020000202000001
1001020000000000001
1001000000011111111
111111111111
