R   600, 540
NO  ./pathno
SO  ./pathso
WE ./pathwe
EA  ./pathea
S   ./pathsprt
F   255, 255, 255
C   255, 255, 0
      1111111111
1111111000000001
1000000001100001  1
10000N0000100001  1
1001000000000001111
1001000000000000001
1001000000000000001
1001000000011111111
111111111111
