R   600,  540

NO  ./textures/strs.xpm

SO  ./textures/eyeballs.xpm

WE ./textures/flw.xpm

EA  ./textures/shrooms2.xpm

S   ./textures/muhomor.xpm

F 38, 38, 38

C   60, 60, 60

      111111111
1111111000000001
1000000001000001  1
10000N0000100001  1
1001000000000001111
1001020000202000021
1001020000000000021
100100000001111111
11111111111
