R 800 800

NO  ./textures/strs.xpm
SO  ./textures/eyeballs.xpm
WE ./textures/flw.xpm
EA  ./textures/shrooms2.xpm
S   ./textures/muhomor_sprite.xpm

F 38,38,38
C 60,60,60

        1111111111111111111111111
        1000000000110000000000001
        1011000001110000002000001
        1001000000000000000000001
111111111011000001110000000000001
100000000011000001110111100111111
11110111111111011100000010001
11110111111111011101010010001
11000000110101011100000000001
10002000000000001100000000001
10000000000000001101010010001
11000001110101011111011110N011
11110111 1110101 101111010001
11111111 1111111 111111111111
