R 600   550

NO ./textures/strs.xpm
SO  ./textures/eyeballs.xpm
WE ./textures/flw.xpm
EA  ./textures/shrooms2.xpm
S   ./textures/muhomor_sprite.xpm

F  38,38,38
C  60,60,60

       111111111
1111111000000001
1000000001000001  1
1000000001101001  1
10010E0002000001111
1001020000202000021
1001020000000020021
1001020000202000021
100100000001111111
11111111111
