R 800 800

NO  ./textures/strs.xpm
SO  ./textures/strs.xpm
WE ./textures/shrooms2.xpm
EA  ./textures/shrooms2.xpm
S   ./textures/muhomor_sprite.xpm

F 38,38,38
C 60,60,60

        1111111111111111111111111
        1000000000110020000000001
        1011000001110000002200001
        1001000000000020000000001
111111111011000001110000000000201
100000000011000001110111100111111
11110111111111011100000010001
11110111111111011101010010001
11000000110101011100200000201
10002000000000001100002000001
10000000000000001101010010001
11000001110101011111011110N011
11110111 1110101 101111010001
11111111 1111111 111111111111
